101 101
#S###################################################################################################
# #                               #               #     #                 # #                 #     #
# # ## ##  #  ###   ## ##   ####### # ## ## # # #   # # # ## # ##  ##   # # # # ##  # #  #  # ##  ###
#   #       #   #         #     #             #   #   # #           #   #     # #   # #   # #   #   #
# ### # #   ### # ##  #   #  ## # ###  ## # # #    ##   ## ## # ##  # ### #   #   ### ##  #   # ##  #
# #   #                         #   # #   #       #   #     #       # #     # # #     #   #   #     #
### ### #  ## # # #### ## ### # ##  # # #  #### ### #####   ### # # # ####### # #    ##  #### # ##  #
#       #   # # #     #   #   #             #     #       # #               # # # # #       #       #
#  ## #  ## # #   ### # ### # ### ##  ####  ##  # ## #### # # ####### ## ##   #       #### # ## # # #
#   # #   # #   # # #         # #         #     #     #   #               # #   #   # #         #   #
#   ####  # #   # #  #### # ### # # #  ## #  ## ####      ## ######  ##  ## ### # # # # #  ## ## ## #
#   #   # #   #   #           #   #             #     #             #           # #   # #   #     # #
# ##  # # # # ##### ##### # # ### ### ###     ##  # ### # # ###   # #   # ### # # #####  ## ## ## # #
# #   #     # #     #             #       # #   #   #   #       # #   # # #   #   #       #   #   # #
# # ## ## # #  ## ###   # ##### ##  # # #  #  # # ### ### ## #  # # ###      ##    # #  # ### # # # #
#           #       # #       # #   #     #   #       #         #         # #     #           #     #
#  ## ##    # # #   ##  ####  # # ### #  ## ### ##### # ##### #   ####   ##   #  ## #### #  #   # # #
#   #   #     # #     #     # #   #   #   #         # # #   # #   #         #     #         # #     #
#   ### # # ### #  ## ##### # # # # ### # ####  # # # # # # #       ## #  # # # # # # # ##### #### ##
# #   # # #     #   #     #   #   #       #   #   #   #   #     #     #             # #     #       #
# #     ##  # ###  ###  # #   # ##  # # ###   # #   # ### # # # ## ## #   ###  #  ##  ### # ### ### #
#         #                 # #             #         #       #         #   # #     # #           # #
# # #  ## ###   # ## ##   # # # #####  ######    ## # # #  ## # # ##### # # ### ##  # #  #  # # ### #
#   # #   #               #   #   #   #             # # #     #       #   #       # #   #   # # #   #
# ##  # # # # ####   ## # # # ### #  ##   # ####### # #  ####   ### # #  ### ## #   #   #     # #   #
# #   #   #       #     #   #     #     # #               #   #     # # #         #           # #   #
# # ### # # # ###  ## ## ## ##  ##  #   # # ### # # ## ####   ##### ### # # # # ##    ## ###### # ###
# # # #         #           #   #   # #   #   # #     #     #       #   #   #   #   #   #       #   #
# # #   ####### ###  ########      ## ###  #  # ## ## # ####  #   #   # # #  # ## # ##  #   ### ### #
# # #   #   #   # #     #   # # #   # #     # #     #         #       #       #   #   # # #         #
### #  # #  # # # # #     # # # # # # ##  ##    ### # # ##  # # # ## ## ### #   ###     # ##### # # #
#   #       # #         # #               #   #   # #   # # # #   # #       # #     # #       # # # #
#  ###  # ### # # ### ### # # ### # ##  ###    ##   ### # #     # # # # ### # ## ####  #### # # #   #
#       #       #     #   # # #     #   #   #   #       # # # #   # #       #               # # # # #
# ##### # # # ### # #   ### #   # # # ### ##### ###   # # #     ### ######  # ### ## ###  #   # # ###
#     # # # #     # #   # #   # # # #   #         #     #   #               #   #     #       # #   #
# ###     #  #      #   # #     # # ###   #   # # # # # # # # # # #   # #####   # ### #### #### ### #
#       #       # # #   #   #   # #   #     # # #     #     #     #   #       #   #   #     #     # #
#  ###### #   ### #     # # # # #  ## # # # # # # ###   ### ##### ### ### #  #  # #  ## ###  #### # #
#   #     # #     #     #   #           # #     #   #   #   # #           #   #   #       #         #
### # # ## #    #   ## ## ### #  #  ### # #      #### # # ##  #  ##  ## ###   # # ### ### #####  #  #
#   # #       #           #   #   #   #   # #   #   # # # #   # #                   #   # #   # #   #
#  ##  #######  # # #  #### ## ##     ### # # ##  #   #   # ##   # #### # ## ## ### # ### #   # #  ##
#         #     #   #         #   #       # #   # #   # # #   #         #     #     #   #       #   #
# # # ### # #####  ## # ####    ### #####   ##### #     # #   ## # ###### # # # ## #### ##### # ### #
#       # #           # # #         #       #     # # #   # #       #   # # #               # #   # #
# # # # # ####  # ## ## # # ##  # ##  # #   # ## ## #   # # # ##  ##  # # # ######### ##  ##  ##    #
# # # # #               # # #           # # # #       #     #   # #   # # # #       #       #       #
# # # # # #####   ######  # # # # ## #    #     ####    # ##### # # ### #   # #   ## #    # # # # ###
# #   # #     #   #   #                 #           # # #       # # #   #   # # #   #         #     #
# ##### # # #####   # # # ## ## # #########  ###### ### ###   ### #      ##   # ##  # # # #####  ## #
#   # #   #       # #             #     #   #     #       #     # #         # #   # # #   #       # #
##  # # #  ##     # #  ###  # ###   ###   ### # # ### # ### ###       # ##### # # # #   # # # # # # #
#   # #   # #   #   #                   # #     #   #   #   #   # # #       # # # #   # #     #     #
# ##  # # # ###########   #####  ## ##    ### # ### ####  #   #  ## #  # ## # # # #  ## # # #   ##  #
# #       #       #               # #         #     #     #   #     # #   # # # #           #   # # #
#       # # # # # # ######  ###   # # #  #####  ##### ### #    ##  ## #  ## #      ## ####  #   # # #
# # #   # # # #   # #     #       # #         # #           #   #   #     #     #           #   #   #
# ### # # ###   # # ### #   #    ##    # ## # # #   # ### # ### ### # ### #  ## ###  ## ## ##   # # #
# #   # #   #     #       # #     #       #   #   # #   # # #       #     #                       # #
# # # # # #  ###    #    ## ### #   ##  # # ## #  # #  ##   # ### # # #  #  ###   ### ######### #   #
#   # #   #     # #   #     #         # # #         # #   # #   # #   #         #       #       #   #
##### ### ### # #  #  # ####  ### #   #   ### # #     # # # ###   # # #    #  # ##  ### # ### ## #  #
#     #     #     #       #   #     # # #   # # #     # #     # #   # #   #     # #       #         #
# ### #  ##   # # # ##### # # #######   # # # # #### ## # # # # ## ##  ## # ##  # # #  ### #### #   #
# #   #   # # #   #     # # #         # # # #   #       #     #           #     #               # # #
# # ##  #   # # #  ####     #   # # ### # # ###     #    #### ####  #####   #####  ## # ### ## ###  #
#           #   #       # # #     # # #   # #     # #       #       #   #     #       #             #
#  ##  # ## # # ##### # # # # #   # # ## ##     #    ## ###  #  # # # ##  # # # #####   # ###### #  #
#           # #               # #   #     # # # #           #   # #   #   # # #     #   #   #       #
# # # ##    # # # #   # ##### # ### # # # # ##  # #   ###   # # #   ###  #  # ## #    # #   ###  ## #
# # #         #   #   #     # # #     #   # #   #   # #   # # #         #   #     #         #       #
# #   # #### ## # # ### # # # # #  ########   ### ### # ##  # ### #####    ### ## ### # # ### ###   #
# #   #         #         # #           #   #       #     # #   #   #     #     #       #           #
#   ### ###   # # # ### #   #  ## # ###   ##  # ##  #  ## # # #   # #  ####    ## ## ## ##### # # # #
# #   #   # #     # #       #     # # #         #   #   # #   #   # #   #           #       #     # #
# ### ###    ######## # # ## # ## #   ##### #  ## # # # # ##  ##     ## #  # ## # # ## ## # # ##  # #
#   #   #   #       # #   #               # # #     #   #   #     # #   #       # #     # #       # #
### #   # ##  # # # # # # # #  #### ##  # ##  #   ## ## ### ####    # ####  ### # ##### # # # #######
#       # #   #   #       #   #         # #   # # #       # #   #   # #   #   # # # #   # # # #     #
# ### # #   ## # ### ####  ##   # # #  ## # ##  # ### ####  #   ##### # # ### #   # #     # #   # # #
#   # #   # #               # #   #   #   # #         #     # #         #       # # #           #   #
#   # # # # # ##### #  ####   # ### # # # # # ### #####  ## # #########  #### ###      ## ##### # ###
# #   # #         # # #   # #       # # #   #   #           #   #   #   #     #   #             #   #
### # ##  # # #     # # # # # # #  #### # #######   #####   #    ## # ### ##  # ### ###   ### ## #  #
#   # #   # #   #       # # #   # #     # #       # #   #     #   # #   #       #       #         # #
#   ###   # ## #   #  #  #  # # #   ##### # ###   # #   #########    ## # # #   ####  #   ###### ## #
#       #       # # #     #   # #   #       #   #     #         # #         # #     #     #       # #
# ####### ##### #     ###    ## ####### # # ## ## ####  # # ### # ####  #  ## # ### ### # # ##### # #
#   #   #       # #               #   #   #       #     #   # # #     #     #     #       # #   #   #
### ###  ###### # # ### ##     ## # # #   ## ###### ##  ### # # #  #  #    ####   ### #     ### ##  #
# #   #   #   #   #   #         #         #         #       #         #   #     #           #   # # #
# ### #   # # #### ####  #  # # # #   # # # #  ##   #  ### #   ####  ##     ## #    ##  ###   # # # #
#     # #       #         # #   #   #   #   #     #     #     #     # # #   # #   #   #   # # #   # #
# ### ### #   # # ####### # # # ###### #####    ####### # # #   #   # # # ##  # ####  ###   # # # # #
# #     # #   # #   # #   # # #           #   #   #     # #     # # #         # # #       #   # #   #
# # #     #  ## ### #   # ### # ### ##### # ## ## # ## #  # ### # # ###### # ## #    # #### # ##  # #
#   # #   # # #     # # #     #           #       #         #   #   #           #   #       # #     #
#####   # #   ###  ## # # ####  ###   # ###   # # # # ### ### # #   # #######   # # ##  ##### # ### #
#           #             #                                       #   #         #       #           #
###################################################################################################E#
